111111111111111111111111111111111111111
100010000000000001111000000000000000001
100010000000000001111000000000000001001
100110000011100001111000000000000001001
100110000010000001111000000000000001001
100110000010000111111000000000000001001
1000000000100001000000000000000000010$1
1000000000100001000000000000000000010$1
111111111110000100001000000000000001001
100000000000000100001000000000000001001
100000000000000100001000000000000001001
100011111111111100001000000000000001001
100000000000000000001000000000000001001
100000000000000000001000000000000000001
111111111111111111111111111111111111111